Title	Content	Coding
With bizarre and profane rhetoric, Trump proves Harris right	Ahead of Donald Trumps campaign rally in Latrobe, Pennsylvania, on Saturday night, one of his senior advisers signaled to reporters that this event would be a little different from most. Specifically… [+3542 chars]	
How election polls are actually getting better	When pollsters failed to see the surge of support for Donald Trump in 2016 and 2020, it seemed like a low point for the industry. But in fact, surveys are getting more accurate, as a look through the… [+60 chars]	
CNN polling shows tight races in Georgia and North Carolina	Neither Vice President Kamala Harris nor former President Donald Trump has established a clear advantage in the race for the White House in two key Southern battleground states, according to new CNN … [+7114 chars]	
America’s economy explains a lot about why Trump got reelected	Donald Trumps decisive election victory was about many things: a global rejection of incumbents, a rise in the Republican electorate and a battle for the future of Americas democracy. But voters cons… [+5751 chars]	
These Trump loyalists named to roles in the new administration once flocked to a courtroom for his criminal trial	"An entourage of GOP elites rallied behind President-elect Donald Trump during his criminal hush-money trial.Curtis Means - Pool/Getty Images
Allies of Donald Trump who backed him during his … [+3437 chars]"	
Mark Cuban says Trump ‘absolutely’ has ‘fascist tendencies’	"Billionaire entrepreneur and television personality Mark Cuban said former President Donald Trump ""absolutely"" has ""fascist tendencies.""
""Do I think that Donald Trump has fascist tendencies? Absolut… [+3570 chars]"	
Video: Mark Cuban, Dana White verbally spar over Kamala Harris vs. Donald Trump ahead of election	"With Election Day less than one week away, all eyes and ears are on the political discourse happening in the U.S.
One debate that took place Wednesday night in front of a national television audienc… [+1010 chars]"	
John Kelly comes out swinging against Trump	John Kelly, a former four-star Marine general and former chief of staff to former President Donald Trump, hammered his old boss in a stunningly public fashion on Tuesday -- just two weeks before Elec… [+4655 chars]	
Elon Musk has spent more than $130 million on Trump and the GOP this year	"Musk has now spent more than $119 million on Trump, making him the ex-president's second largest financial backer.Anna Moneymaker/Getty Images
Elon Musk's publicly disclosed spending for Tru… [+2540 chars]"	
Donald Trump projected to become the 47th president of the United States	"Good morning and welcome to Fox News morning newsletter, Fox News First. And here's what you need to know to start your day ...
YOUR ELECTION HUB: Track election results with real-time data, develop… [+2943 chars]"	
23 Nobel Prize-winning economists call Harris’ economic plan ‘vastly superior’ to Trump’s | CNN Politics	More than half of the living US recipients of the Nobel Prize for economics signed a letter that called Vice President Kamala Harris economic agenda vastly superior to the plans laid out by former Pr… [+6152 chars]	
I ran Twitter’s civic integrity team. Here’s what Elon Musk gets wrong about elections.	"Heres a timeless dictum that aptly applies to election administration: Everything looks suspicious when you dont know how anything works.
Elections are a complex mix of diverse laws, procedures, tec… [+6595 chars]"	
What we've learned from the consistent poll numbers shaping the 2024 election	"Lets get one thing straight: The polls cant tell us who is going to win the presidential election. Or which party will control Congress. Or who will win a particular state.
The race is that close an… [+5410 chars]"	
Ask Jordan: Would Harris be immune from prosecution too?	"If Harris is elected, how would the Supreme Court ruling on immunity affect her as president regarding decisions in the future?
 Charles Kuhn, Saratoga, California
Hi Charles,
The Supreme Courts i… [+2063 chars]"	
CNN Polls: Harris has a narrow edge in Michigan and Wisconsin, while she and Trump remain tied in Pennsylvania	Vice President Kamala Harris maintains a narrow advantage in two of the three blue wall states that collectively represent her clearest path to an Electoral College victory over former President Dona… [+8308 chars]	
Joe Rogan asks Trump about warm welcome he once received on 'The View': 'They all loved you'	"Podcast host Joe Rogan asked former President Trump on Friday about an appearance he did on ABC's ""The View,"" prior to running for president. He reminded the former president that the women of the pr… [+3073 chars]"	
Silicon Valley's Trump boosters celebrate: 'It's time to build'	"Elon Musk jumps for joy at Trump's rally in Butler, Pennsylvania.Jim Watson/AFP via Getty Images
Tech leaders who openly supported Donald Trump took to X to celebrate his win Wednesday morni… [+4286 chars]"	
Harris wants to upgrade America’s economy. Trump wants to blow it up and start over | CNN Business	"Vice President Kamala Harris wants to renovate the American economy. Former President Donald Trumps economic vision amounts to knocking it down and rebuilding it from the ground up.
The Harris econo… [+6062 chars]"	
Harris maintains strong lead among Black swing-state voters in a new poll	Vice President Kamala Harris still has a wide lead over former President Donald Trump among Black voters in battleground states, according to a new poll, which shows a key slice of undecided Black vo… [+3908 chars]	
Trump's tariffs will make it hard for automakers — including Tesla — to set up shop in Mexico	"A billboard welcoming Tesla to the Mexican state of Nuevo León, which was set to host Tesla's gigafactory.JULIO CESAR AGUILAR/AFP via Getty Images
Tesla's $10 billion Mexico gigafactory is i… [+5774 chars]"	
Elon Musk went all-in on Pennsylvania — and his expensive effort paid off big time	Elon Musk, the world's richest man, took a frenzied and controversial gamble on the biggest swing state in the 2024 race, and it paid off. President-elect Donald Trump won Pennsylvania and, with it, … [+7408 chars]	
Trump campaign defends his remarks about violence toward journalists	"Former President Donald Trump is doing damage control after seemingly espousing violence toward journalists.
During a campaign rally in Lititz, Pennsylvania, on Sunday, Trump made comments suggestin… [+1767 chars]"	
Donald Trump says press has lost all credibility, blasts Liz Cheney over distorted comments	"Former President Donald Trump joined ""Fox &amp; Friends Weekend"" to speak about the loss of public trust in the media and to respond to criticisms levied against him over comments that he made about … [+2698 chars]"	
What does it mean to ‘crash out’? A look at the phrase and why it’s rising in popularity	"A new slang phrase is making its way around social media, specifically following the results of the 2024 presidential election.
""Crash out"" has been in the Gen Alpha and Gen Z vernacular for several… [+3552 chars]"	
'Adjourn, adjourn, adjourn' — Trump is expected to use new status as president-elect to delay hush-money sentencing	"President-elect Donald Trump speaks at an election night event at the Palm Beach Convention Center on November 06, 2024Chip Somodevilla/Getty Images
Trump will try to use his new status as p… [+6616 chars]"	
Donald Trump, WWE legend The Undertaker discuss intricacies of wrestling: 'I find it very interesting'	"In continuing his media buzz ahead of the election, former President Donald Trump dipped back into the sports world, but in a different avenue.
The three-time Republican nominee appeared on the ""Six… [+3239 chars]"	
Live updates: Donald Trump, Kamala Harris election news | CNN Politics	Vice President Kamala Harris appeared on Saturday Night Live, making a surprise stop during the shows last episode before Election Day to give her fictional self some advice ahead of Tuesdays preside… [+1516 chars]	
Biden and Trump to meet Wednesday at the White House	"WASHINGTON President Joe Biden and President-elect Donald Trump will meet on Wednesday in the Oval Office.
The meeting will take place at 11:00 a.m., Biden press secretary Karine Jean-Pierre said in… [+231 chars]"	
Elon Musk daily $1 million payouts at Trump rally draw legal scrutiny	Billionaire Elon Musk promised on Saturday to give away $1 million each day until November's election to someone who signs his online petition, with the first prize awarded at a PAC event supporting … [+2983 chars]	
What would a Kamala Harris or Donald Trump victory mean for the stock market?	The stock market has climbed over the course of the presidential campaign, raising questions about whether the rally will continue depending upon which candidate wins: Vice President Kamala Harris or… [+4537 chars]	
JASON CHAFFETZ: How did Trump do it?	"Join Fox News for access to this content
Plus special access to select articles and other premium content with your account - free of charge.
By entering your email and pushing continue, you are ag… [+4231 chars]"	
Boxing Hall of Famer Thomas 'Hitman' Hearns joins Trump on stage at Detroit rally: 'This can't be real'	"Former President Trump held a rally in the Detroit area, and he invited a local legend to the stage.
The three-time Republican presidential nominee was at Huntington Place in downtown Detroit, and, … [+1801 chars]"	
Highlights from President-elect Donald Trump’s first term as president of the United States	"President-elect Trump secured a second term in office after defeating Vice President Kamala Harris in the 2024 presidential election race. 
Trump served his first term after winning the 2016 preside… [+6583 chars]"	
Small and 'chaotic' House Republican majority poses challenges for the new Trump era	WASHINGTON Over the last two years, a narrow Republican House majority has fought bitterly over everything from electing a speaker, keeping the government functioning and even passing symbolic messag… [+8090 chars]	
Summers sounds alarm bell on inflation...	"When many were celebrating the remarkable economic recovery from the pandemic in the spring of 2021, Larry Summers warned the White House and the rest of Washington that inflation was a real danger.… [+3320 chars]"	
Officials prepare for protests and possible violence on Election Day | The Excerpt	On Fridays episode of The Excerpt podcast (first released on November 1, 2024): USA TODAY Senior National Political Correspondent Sarah D. Wire discusses preparations ahead of Tuesday at election off… [+13451 chars]	
'Shark Tank' star Mark Cuban says Donald Trump's China tariffs would ruin Christmas next year	"""Shark Tank"" star Mark Cuban said Donald Trump's planned tariffs would ruin Christmas next year.Allen Berezovsky via Getty Images; Jeff Kowalsky/AFP via Getty Images
Donald Trump's planned t… [+2250 chars]"	
Trump has promised lower interest rates. That will be largely out of his control.	"WASHINGTON As a candidate, Donald Trump promised to relieve consumers of high interest rates. As president, doing so will likely be a slow process largely outside of his control.
Trump repeatedly sa… [+5951 chars]"	
FEMA employee fired after advising disaster relief team not to visit homes with pro-Trump signs	"A Federal Emergency Management Agency employee was fired after recently advising a disaster relief team to not visit homes with yard signs that support President-elect Donald Trump. 
FEMA did not cl… [+1423 chars]"	
How Donald Trump is laying the groundwork to dispute the election results – again | CNN Politics	Donald Trump is re-using his 2020 playbook to baselessly claim the 2024 election is being stolen from him and is being joined by allies with big megaphones amplifying his falsehoods ahead of Election… [+15894 chars]	
Trump, Harris nearly tied in Michigan as Election Day nears, poll finds	"A new poll has found that former President Donald Trump and Vice President Kamala Harris are essentially tied among voters in the battleground state of Michigan. 
The Washington Post poll of 1,004 r… [+1524 chars]"	
WWE legend Hulk Hogan says Trump assassination attempt forced him to speak up: 'This has to stop'	"Join Fox News for access to this content
Plus special access to select articles and other premium content with your account - free of charge.
By entering your email and pushing continue, you are ag… [+2900 chars]"	
Don compares jailed Capitol rioters to Japanese internment during WWII...	Former President Donald Trump said that rioters who stormed the U.S. Capitol on Jan. 6, 2021 are being treated like Japanese Americans who were incarcerated on U.S. soil during World War II.	
Trump’s second term will look nothing like his first | CNN Politics	"Donald Trumps election victory will return him to the White House, but both his allies and detractors have made clear his second time around will look nothing like the first.
With the Republican Par… [+8775 chars]"	
Jeff Yass is making a big final splash to help former hedge funder Dave McCormick's Senate campaign	"Former Bridgewater Associates CEO Dave McCormick has his old Wall Street pals to thank for helping pad the coffers of a supportive super PAC.Anna Moneymaker/Getty Images
Former hedge funder … [+2450 chars]"	
What's next for tech giants like Google, Apple, and Microsoft now that Trump has won	"Donald Trump at a Philadelphia campaign rally.Anna Moneymaker/Getty Images
The tech sector is bracing itself for change under a second Trump presidency.AI regulation is likely to ch… [+10591 chars]"	
Black men are a coveted — somewhat movable — voting bloc. Seven told us how they planned to vote.	As Election Day approaches, the campaigns are putting significant time and attention toward courting Black men, seen as a crucial and potentially movable voting bloc in a tight presidential race. Bot… [+14275 chars]	
Susie Wiles, Trump’s incoming chief of staff, has withstood his political whims (so far)	Donald Trump announced his first staffing choices for his administration Thursday, naming longtime Republican political operative Susie Wiles, who worked on all three of his presidential campaigns, a… [+2168 chars]	
Trump, Harris neck and neck as Dems lose ground among Latino, Black voters: poll	Former President Donald Trump and Vice President Kamala Harris are neck and neck in recent polling as they enter the final leg of the presidential race, as the Democratic nominee appears to be losing… [+3419 chars]	
The blue wall was Kamala Harris' clearest path to the White House. Here's why it faded away.	"Vice President Kamala Harris made a final push for votes with an Election Day eve rally in Philadelphia.AP Photo/Jacquelyn Martin
Democrats hoped Vice President Harris could win the White Ho… [+5698 chars]"	
Tracking who Trump has named to serve in his Cabinet, administration	"President-elect Donald Trump, ahead of his return to power in January, is announcing who he wants to fill Cabinet positions and other key roles inside his administration.
Trump began to roll out his… [+6600 chars]"	
Trump and Harris hold dueling events in Texas	"Former GOP Rep. Liz Cheney will campaign in Michigan on Monday with Rep. Elissa Slotkin, Democrats' Senate nominee in Michigan.
Cheney and Slotkin will be in Grand Rapids, once a conservative strong… [+1507 chars]"	
Donald Trump’s top three ‘SNL’ moments	"Presidential nominees Donald Trump and Kamala Harris have now both appeared on ""Saturday Night Live,"" though at very different points in their campaigns.
Harris brief appearance, playing herself opp… [+3900 chars]"	
The view from abroad: Foreign policy in the 2024 US presidential election	"LONDON -- The showdown between Vice President Kamala Harris and former President Donald Trump will in many ways be a choice between foreign policy continuity and change.
Harris has largely stuck to … [+13360 chars]"	
Live updates: Trump wins the 2024 presidential election, CNN projects | CNN Politics	Russian President Vladimir Putin has no plans to congratulate Donald Trump, the Kremlin spokesperson said, adding, Lets not forget that we are talking about an unfriendly country that is both directl… [+1767 chars]	
Justice Dept. to focus on 'most egregious' Jan. 6 cases until Trump is inaugurated	"WASHINGTON The Justice Department plans to focus on arresting the ""most egregious"" Jan. 6 rioters particularly those who committed felony assaults on law enforcement officers but have not yet been ar… [+6673 chars]"	
Federal Reserve blocks Basel Committee’s climate disclosure plan, raising tensions with Europe	US regulators led by the Federal Reserve have refused to endorse a plan that would have seen the Basel Committee on Banking Supervision push lenders to disclose their climate risk, according to peopl… [+7610 chars]	
Blinken entourage rushes to shelter amid Hezbollah attack on Tel Aviv | The Excerpt	On Thursday's episode of The Excerpt podcast: Secretary of State Anthony Blinken is visiting the Middle East this week, amid heightened tensions. North Korean troops are in Russia, according to the U… [+16451 chars]	
Sales of 'The Handmaid's Tale' rose nearly 7,000% this week on Amazon — but 'Melania' takes the No. 1 bestseller spot	"Since Donald Trump was declared the winner of the 2024 election, Margaret Atwood's 1985 dystopian novel ""The Handmaid's Tale"" has surged from No. 209 to No. 2 on the Amazon Best Sellers list.
By Thu… [+2064 chars]"	
Elon Musk keeps up pro-Trump spending spree as Harris continues to dominate money race, new filings show | CNN Politics	Elon Musk plowed nearly $44 million in October into a super PAC working to restore Donald Trump to the White House pushing the billionaires total donations to the group he established to benefit the … [+5653 chars]	
America's chipmaking push will continue no matter who gets elected	"Efforts to boost the US's production of semiconductor chips are likely to continue regardless of who wins the presidential election.iStock; Rebecca Zisser/BI
US efforts to produce semiconduc… [+8420 chars]"	
The S&P 500 will gain 11% by mid-2025 as the bull market accelerates under Trump, Evercore says	"It is still early days for the bull market and the rally is set to accelerate under the coming Donald Trump presidency, according to Evercore ISI analyst Julian Emanuel.
Emanuel says the S&amp;P 500… [+1488 chars]"	
Harris holds narrow lead over Trump in 'blue wall' states Michigan, Pennsylvania, Wisconsin: poll	"A slew of new polls show Vice President Kamala Harris taking a narrow lead over former President Donald Trump in the ""blue wall"" states many forecasters say she needs to win to clinch the presidency.… [+3686 chars]"	
Harris' chances are still alive after she won a key vote in Nebraska	Vice President Kamala Harris' increasingly perilous path to the White House is still alive thanks to her projected win of Nebraska's 2nd Congressional District, carrying an area that was once reliabl… [+2142 chars]	
Dogecoin spikes another 15% after Musk appointed to lead DOGE department for Trump	"Dogecoin has gotten a big boost since Donald Trump won the presidential election last week amid a market-wide surge for cryptos of all types.
The dog-themed crypto had surged roughly 140% since Nove… [+1451 chars]"	
Election betting odds tighten as polls show Harris has momentum	"Vice President Kamala Harris' betting odds jumped overnight after a new poll showed she held a surprise lead over former President Donald Trump in Iowa a state he won easily in both 2016 and 2020.
A… [+1284 chars]"	
Why Aileen Cannon may have won big at the ballot box	While its only a matter of time before Donald Trumps federal criminal cases are gone, theres an important distinction between the two prosecutions, which the Justice Department reportedly has been ev… [+1734 chars]	
Election Day officially begins as Harris, Trump tie in Dixville Notch midnight vote	"Vice President Kamala Harris and former President Donald Trump have tied in the Dixville Notch midnight vote kicking off the official start to 2024's Election Day.
Following the national trends, ind… [+1373 chars]"	
Trump asks Rep. Mike Waltz, China hawk, to be his national security adviser	WASHINGTON President-elect Donald Trump has asked U.S. Rep. Michael Waltz, a retired Army National Guard officer and war veteran, to be his national security adviser, a person familiar with the matte… [+9877 chars]	
Joe Rogan endorsed Donald Trump, saying Elon Musk made a 'compelling case' for the former president	"Joe Rogan endorsed Donald Trump ahead of the election.Getty Images
Podcaster Joe Rogan endorsed Donald Trump in a Monday evening post.Rogan cited Elon Musk, saying the billionaire m… [+2133 chars]"	
Jack Smith plans to step down before Donald Trump takes office	"Special counsel Jack Smith and his team plan to resign before President-elect Donald Trump takes office, NBC News reported, citing a source familiar with the matter.
The New York Times, citing peopl… [+2209 chars]"	
The data is in: Trump’s age isn’t getting the coverage it deserves	Donald Trump or Kamala Harris could be the most consequential president ever elected, such is the crossroads where we find our country. And as Trumps increasingly erratic behavior is raising question… [+4197 chars]	
BRENT BOZELL: The surprising way Donald Trump can win it all against Kamala Harris	"Join Fox News for access to this content
Plus special access to select articles and other premium content with your account - free of charge.
By entering your email and pushing continue, you are ag… [+5828 chars]"	
At the finish line, Trump’s former vice president still isn’t backing him	Its been nearly eight months since former Vice President Mike Pence appeared on Fox News and gave the political world an unexpected jolt. Donald Trump is pursuing and articulating an agenda that is a… [+2625 chars]	
Why JPMorgan says election gridlock will be the best-case scenario for stocks	"Regardless of the next president, JPMorgan expects stocks to rise if the US election delivers a divided Congress.
""Under either gridlock scenario, we think equities reprice higher as we clear the un… [+1859 chars]"	
Unsealing of filing offers limited look at evidence in Jan. 6 case against Trump	The judge overseeing Donald Trump's federal election interference case on Friday unsealed the redacted appendix of evidence gathered by special counsel Jack Smith, offering a glimpse of the evidence … [+2985 chars]	
Harris and Trump make a furious final push before Election Day	RALEIGH, N.C. A presidential campaign that has careened through a felony trial, an incumbent president being pushed off the ticket and multiple assassination attempts comes down to a final sprint acr… [+13440 chars]	
Trump’s offensive against the free press takes an unsettling turn	Donald Trumps principal opponent is, of course, Kamala Harris, but the former president targets independent news organizations with nearly the same vigor as the Democratic vice president. There are, … [+2336 chars]	
WaPo editor on how the 2024 election will be remembered	"Mary Jordan, associate editor at the Washington Post, sat down with ABC News to discuss Donald Trump's historic victory and what Melania Trump's second term as first lady might look like.
Jordan, th… [+4326 chars]"	
Opinion: I asked Mark Cuban why he has gone all in for Harris. Here's what he told me.	"Mark Cuban might make a good president someday, but he hasn't ventured far into politics.
At least, until this year.
The part owner of the NBA Dallas Mavericks and a ""Shark Tank"" investor isn't exa… [+8513 chars]"	
Trump’s former pick to join the Federal Reserve has proposed a radical solution to solve inflation	"Millions of Americans are frustrated that their dollars arent going as far as they once did at the supermarket, on rent or on car insurance.
Judy Shelton, a controversial economist who has been floa… [+6270 chars]"	
Cardinal Dolan 'upset' that Harris skipping Al Smith Dinner	"Cardinal Timothy Dolan, the Archbishop of New York, said he was ""upset"" that Vice President Harris, the Democratic presidential nominee, is skipping out on the Al Smith charity dinner on Thursday. 
… [+2922 chars]"	
Harris showed minimal losses among Black men, but analysts say she should have won more	Black men had been perceived as a voting bloc ripe for Donald Trump to attract after many expressed concerns a year ago about Joe Bidens re-election efforts. An NBC News poll at that time showed that… [+6109 chars]	
Inside Trump and Putin's first phone call since the election	"President-elect Donald Trump told Russian President Vladimir Putin not to escalate the war in Ukraine during a phone call last week, The Washington Post reported on Sunday.
The phone call on Thursda… [+2876 chars]"	
Benjamin Netanyahu won the U.S. presidential election	Israeli Prime Minister Benjamin Netanyahu, whose leadership credentials, judgment and popularity have taken a big hit since Hamas Oct. 7, 2023, attacks on Israel and the subsequent wars in Gaza and L… [+7022 chars]	
As Trump targets the free press, there’s no room for cowardice	At a campaign rally in Michigan on Friday night, Donald Trump returned to one of the few messages he emphasizes just about every day as Election Day draws closer. 60 Minutes should be taken off the a… [+4059 chars]	
The Federal Reserve gives Americans another interest rate cut	"Federal Reserve chair Jerome Powell announced another interest rate cut.MANDEL NGAN/AFP via Getty Images; Chelsea Jia Feng/BI
The Federal Reserve cut interest rates by 25 basis points on Thu… [+2827 chars]"	
Rapper Young Thug pleads guilty in YSL Records case in Atlanta	But Fulton County Superior Court Judge Paige Reese Whitaker rejected that suggestion. She sentenced the rapper to 40 years, with five years in prison. Whitaker also commuted the sentence to time serv… [+10572 chars]	
Donald Trump again asks court to dismiss January 6 criminal case, saying special counsel is unconstitutional | CNN Politics	Donald Trumps legal team is asking a federal court to dismiss the January 6, 2021, election subversion case, saying that the office of special counsel Jack Smith is unconstitutional, in a court filin… [+4142 chars]	
RFK Jr. asks Supreme Court to take him off Wisconsin ballot, despite missing deadline	WASHINGTON Robert F. Kennedy Jr. has asked the Supreme Court to take his name off the presidential ballot in Wisconsin in an emergency petition filed weeks after hundreds of thousands of ballots have… [+1904 chars]	
Trump’s 2024 victory revealed voter shifts that could reshape America’s political landscape | CNN Politics	President-elect Donald Trump won across the map improving on Republican margins nearly everywhere and delivering on his promises to win over more non-White voters on his way to defeating Vice Preside… [+8543 chars]	
WATCH: JD Vance will still ‘love you’ if you don’t vote for him	"Trump and Harris make final push, get last-minute endorsements
North Carolina voters head to polls in wake of hurricanes
Harris makes final pitch to voters across Pennsylv… [+4168 chars]"	
Trump turns to allies on capitol hill to fill top cabinet posts	President-elect Donald Trump is raiding the House of Representatives as he stocks his cabinet, threatening to cut into whats likely to be a razor-thin majority for Speaker Mike Johnson in the early d… [+9239 chars]	
What mattered more to Trump: Musk's money, or Musk's platform?	"Elon Musk's support for Trump helped land him an onstage appearance at last month's Madison Square Garden rally.Jabin Botsford/The Washington Post via Getty Images
Elon Musk's Twitter purcha… [+3160 chars]"	
Flight logs show Elon Musk's private jets are busy hitting swing states as he campaigns for Trump	"Elon Musk is campaigning for Donald Trump in Pennsylvania.Ryan Collerd/AFP via Getty Images
Elon Musk's private planes made eight flights to Pennsylvania this past week, flight logs show.</l… [+4318 chars]"	
Trump posts AI-generated photo of himself as Steelers player, wearing No 47, ahead of appearance at game	"The Pittsburgh Steelers did not need much help handling the New York Jets on Sunday, but former President Donald Trump was ready if needed.
The Steelers defeated the Jets, 37-15, on Sunday night in … [+1701 chars]"	
Vance, in Joe Rogan interview, predicts Trump will win 'the normal gay guy vote'	In an interview with popular podcaster Joe Rogan, Republican vice presidential nominee JD Vance suggested that he and Donald Trump can win the normal gay guy vote and that families with transgender c… [+6359 chars]	
Why Trump can’t pretend his rally’s anti-Puerto Rican racism was just a joke	"I am Puerto Rican, and I am tired.
When comedian Tony Hinchcliffe joked Sunday that Puerto Rico was a floating island of garbage at the start of a Donald Trump rally at Madison Square Garden, I was … [+4762 chars]"	
Polls close in Georgia, North Carolina as US results roll iIn	Polls closed across nine US states including the pivotal battlegrounds of Georgia and North Carolina and early results are beginning to be tallied as the nation watches for signs of how voters broke … [+8885 chars]	
Woman runs onto Steelers' field with pro-Trump sign as former president attends game	"One woman really wanted to impress former President Donald Trump on Sunday night.
The former president, and current Republican nominee, attended Sunday night's NFL game between the Pittsburgh Steele… [+1547 chars]"	
Supreme Court hears from two of Trump's longtime antagonists	Welcome back, Deadline: Legal Newsletter readers. The Supreme Court just wrapped its October argument session. The week featured a Joe Biden win on pollution rules, a loss for Donald Trump foe Michae… [+5222 chars]	
Trump plans to pressure police departments to help with mass deportations	As Donald Trump promises the largest mass deportation of undocumented immigrants in U.S. history if re-elected, his team is considering withholding federal police grants from local law enforcement ag… [+4414 chars]	
ABC poll: Immigration, abortion see highest partisan splits in importance	The latest poll conducted by Ipsos and Langer Research for ABC News found that the widest gap between Democrats and Republicans on what issues are considered important were over abortion and immigrat… [+2988 chars]	
Election 2024 live updates: Donald Trump holds rally in Madison Square Garden	"Former President Donald Trump is headlining a hometown rally at New York City's Madison Square Garden on Sunday night.
Trump, born in Queens, New York, likely won't win the dark-blue Empire State on… [+3826 chars]"	
After Trump’s win, some women are considering the 4B movement	"Yahoo is using AI to generate takeaways from this article. This means the info may not always match what's in the article. Reporting mistakes helps us improve the experience.Generate Key Takeaways
I… [+8126 chars]"	
Why Nikki Haley and Mike Pompeo won’t be on Trump’s second term team	Donald Trumps second-term team is just now starting to take shape, with the president-elect selecting Susie Wiles to serve as his White House chief of staff and House Republican Conference Chair Elis… [+2895 chars]	
WATCH: Trump blasted by former chief of staff	"Whats next for Russia? 
What comes next after Texas school shooting?
What's next for abortion rights in America?
The new battle for voting rights
How w… [+2284 chars]"	
Trump threatens to drown out his closing message in the final days of the election	"Are you better off now than you were four years ago?
That has been the question posed by Donald Trump to begin each of his campaign rallies over the past week. 
Pieced together, those more than a h… [+9007 chars]"	
Bill Gates privately said he donated $50 million to a pro-Harris super PAC, The New York Times reports	"Bill Gates made a donation to a pro-Harris super-PAC, three people briefed on the matter told The New York Times.Sean Gallup/Getty Images
Bill Gates said he donated millions to a pro-Harris … [+2977 chars]"	
Trump’s social media stock spikes as America goes to the polls | CNN Business	"Former President Donald Trumps social media company is surging on Election Day as it faces a potential make-or-break moment that will be decided by voters.
Shares of Truth Social owner Trump Media &… [+2346 chars]"	
How Donald Trump won the presidency	Former President Donald Trump is projected to be the next president of the United States, according to an ABC News projection issued at 5:31 a.m. Eastern on Wednesday, Nov. 6. As of 6 a.m. Eastern, G… [+5045 chars]	
Trump has been re-elected. But now we know exactly who he is.	The most unusual presidential election of our lifetimes has ended, and Donald Trump has won, NBC News projects. Now, millions of worried Americans have one question on their minds: What comes next? H… [+5148 chars]	
Trump’s growing threats to strip broadcast licenses send chills across industry | CNN Business	"Broadcast television licensing is not ordinarily a hot topic during a presidential election. But Donald Trumps threats are not ordinary, either.
In the past two years, Trump has called for every maj… [+6838 chars]"	
WATCH: Trump: 'We overcame obstacles that nobody thought possible'	"2024 Election: Kamala Harris projected to win New Jersey, Minnesota
Trump: 'We overcame obstacles that nobody thought possible'
2024 Election: Donald Trump projected to wi… [+4269 chars]"	
Interest spikes in fringe '4B' movement of women who abstain from marriage and sex with men	"The election of Donald Trump as the next U.S. president has triggered a surge of social media posts and internet search interest in South Koreas fringe feminist ""4B"" movement, which calls on women to… [+6736 chars]"	
Harris, Trump locked in dead heat in battleground Wisconsin, new exclusive poll says	"Former President Donald Trump and Vice President Kamala Harris are locked in a dead heat in the battleground state of Wisconsin, according to an exclusive new USA TODAY/Suffolk University poll.
With… [+7061 chars]"	
Bitcoin ETFs see highest daily outflows ever as traders brace for Election Day volatility	"Investors pulled a record amount from bitcoin exchange-traded funds to start the week as they prepared for volatility in the world's largest crypto amid potential election uncertainty. 
Bloomberg da… [+2021 chars]"	
Biden seeks to clean up 'garbage' comment about Trump supporters...	President Joe Biden on Tuesday tried to clean up comments he made earlier that sparked immediate backlash from many who interpreted them as referring to supporters of former President Donald Trump as… [+5091 chars]	
Biden says 'giving up is unforgivable' after Trump's election win	"WASHINGTON President Joe Biden vowed Thursday he will ensure a peaceful transfer of power following President-elect Donald Trump's resounding election victory and told his supporters ""a defeat does n… [+4704 chars]"	
Volatility, higher rates, and surging bitcoin. Here's what analysts are saying about Trump's victory.	"Analysts say Donald Trump's victory ushers in a new era for US economic policy.Justin Sullivan/Getty Images
Donald Trump won a second term in Tuesday's presidential election.Analyst… [+2919 chars]"	
Trump campaign looks to Vance to help them over the finish line in Pennsylvania	From the moment he arrived in Milwaukee, Wisconsin, after being named former President Donald Trump's running mate, it was clear that one of Sen. JD Vance's primary roles was to help deliver battlegr… [+4370 chars]	
What's at stake for Elon Musk in the presidential election?	"Elon Musk, the world's richest person, has launched a far-reaching effort to help elect former President Donald Trump.
Musk, who owns X, frequently posts messages in support of Trump on the social m… [+7841 chars]"	
How Trump broke both parties — and where Democrats go from here: From the Politics Desk	Welcome to the online version of From the Politics Desk, an evening newsletter that brings you the NBC News Politics teams latest reporting and analysis from the campaign trail, the White House and C… [+8893 chars]	
Trump makes gains with some Puerto Ricans this election despite controversial 'garbage' joke	"The controversial ""floating garbage"" joke about Puerto Rico made by a comedian at a rally for Republican President-elect Donald Trump during the final days before the election may not have had the ne… [+3103 chars]"	
Stocks surge to record highs as Trump returns to presidency	All three major indexes hit record highsTrump-linked stocks, Tesla jumpMarket volatility gauge falls sharplyShares of small-cap companies soarNEW YORK U.S… [+4217 chars]	
The world's right-wing leaders celebrate a Trump win — but America's traditional allies hint unease	"President Volodymyr Zelenskyy welcomed Trumps decisive leadership and his peace through strength approach in global affairs.
Some Ukrainians were nonplussed by what they saw as the equivocal support… [+1576 chars]"	
Army report on Trump Arlington Cemetery incident released but almost entirely redacted	The U.S. Armys long-anticipated report on Donald Trumps controversial visit to Arlington National Cemetery in August has been released, but the report sheds little light on what actually happened tha… [+2304 chars]	
Russian smear of Tim Walz hits internet ahead of US election	WASHINGTON U.S. intelligence officials say Russia is behind a fake video smearing Democratic vice-presidential nominee Tim Walz with false sexual abuse allegations as part of an election interference… [+4017 chars]	
DJT shares implode right before the election, losing Trump $2.4 billion in net worth	"Former President Donald Trumps social media stock is plunging just ahead of the election, cutting deeply into his net worth.
After an absurd spike over the past five weeks that was based entirely on… [+3195 chars]"	
Melania Trump defends her husband: 'He is not Hitler'	"After making a surprise appearance at her husband's Madison Square Garden rally on Sunday, Melania Trump spoke out on ""Fox and Friends"" on Tuesday, fiercely defending him against reported comments th… [+3398 chars]"	
Legendary investor Paul Tudor Jones says he's buying gold and bitcoin pre-election because inflation will rise under both Trump and Harris	"Paul Tudor Jones is holding gold, bitcoin, and commodities to hedge against inflation, as neither presidential candidate has a plan suitable for tackling US debt, the legendary investor said.
The bi… [+2252 chars]"	
Harris doubles down on 'Hitler' comments at start of CNN town hall: 'unstable'	"Join Fox News for access to this content
Plus special access to select articles and other premium content with your account - free of charge.
By entering your email and pushing continue, you are ag… [+4113 chars]"	
Senate Republicans to choose new leader as Mitch McConnell steps down	WASHINGTON Senate Republicans will meet behind closed doors Wednesday to elect a new leader, capping a battle that has divided the party and pitted a candidate backed by vocal MAGA allies of Presiden… [+4911 chars]	
Trump and Harris offer split-screen closing messages in dueling Milwaukee rallies	"Donald Trump and Kamala Harris' differing styles were on full display during dueling rallies Friday night in Milwaukee, the largest city in one of the nations most important swing states.
The two he… [+5862 chars]"	
Trump victory gives Modi chance to reset India’s image with the West	"Few leaders in Asia are more happy to see Donald Trump heading back to the White House than Indian Prime Minister Narendra Modi. 
Modi became one of the first major leaders to congratulate Trump on … [+6089 chars]"	
Fed Chair Powell stands firm amid questioning about whether Trump will push him out	"Federal Reserve chair Jerome Powell has no plans to leave the central bank prematurely under President-elect Donald Trump.
On Thursday, the Federal Open Market Committee announced a 25-basis-point i… [+2171 chars]"	
Fox News AI Newsletter: AI developers discover 'Donald Trump neuron', expert says	"Welcome to Fox News Artificial Intelligence newsletter with the latest AI technology advancements.
IN TODAYS NEWSLETTER:
- AI developers discover 'Donald Trump neuron', expert says
- Petition call… [+1662 chars]"	
Racist comments at Trump's Madison Square Garden rally overshadow 'closing argument'	"Former president Donald Trump's rally at Madison Square Garden on Sunday was framed as his ""closing argument"" in his bid for the White House and as a way to bring a diverse group of supporters togeth… [+4496 chars]"	
Dana White goes full MAGA during Donald Trump victory speech, thanks 'mighty and powerful Joe Rogan'	"Despite his status as a political pariah four years ago, former President Donald Trump pulled off a decisive victory over Vice President Kamala Harris as he was elected to another term Wednesday.
Tr… [+2061 chars]"	
Tesla hits a $1 trillion market cap after the stock rallies 27% following Trump's election win	"Tesla hit a $1 trillion market valuation for the first time since April 2022.
The stock surged as much as 7% on Friday to an intraday peak of $319.44, with shares soaring 27% since Donald Trump was … [+1455 chars]"	
Here’s what to remember if Donald Trump tries to claim he won early on election night	While we cant be certain who will win the presidential election, we can predict one thing with a high degree of confidence: Donald Trump will claim he won. And hell probably do this on Tuesday night.… [+4649 chars]	
Fox News projects Trump victory over Harris in Pennsylvania	"Fox News Decision Desk projects former President Donald Trump has won the critical swing state of Pennsylvania over Vice President Kamala Harris. 
Polls showed a close race throughout the campaign f… [+4146 chars]"	
Elon Musk joins Donald Trump in 'very good call' with Ukrainian President Zelenskyy	"A senior Ukrainian official confirmed to Fox News that Elon Musk joined a Trump-Zelenskyy call on Wednesday in which President Zelenskyy congratulated the president-elect on his win.
""It was a very … [+1945 chars]"	
Trump 'won fair and square': Business leaders from Mark Cuban to David Sacks react to election result	"The business world was divided in the run-up to the election.Anna Moneymaker/Getty Images
Business leaders have been reacting to Donald Trump's presidential election victory.Silicon… [+8169 chars]"	
Non-US stocks have seen their sharpest sell-off since August on fears over Trump's tariffs	"Donald Trump's win has sent US stocks on a tear, but for equities in the rest of the world, it's sparked a sell-off on fears of a widespread economic downturn due to tariff risks.
An MSCI index of l… [+1960 chars]"	
Trump is already wielding power and causing massive disruption	"President-elect Donald Trump is already flexing raw power, showing he may try to subvert Washingtons checks and balances and leaving foreign leaders scrambling to come to terms with his victory.
Ear… [+10400 chars]"	
Dave Bautista’s attack on Trump wasn’t just about jokes	"If you watched Wednesday nights episode of Jimmy Kimmel Live! you likely saw Dave Bautistas NSFW sketch attacking Donald Trumps tough guy persona.
Funny as it was, I think the value is far greater t… [+3394 chars]"	
Why the ‘little secret’ between Trump and Speaker Johnson matters	Donald Trumps rally at Madison Square Garden was ugly and vulgar in a great many ways, but it was also lacking in subtlety. There was text, not subtext. The Republican and his allies relied on chains… [+2262 chars]	
Democrats would get nothing for throwing trans Americans under the bus	Democrats are still reeling from the wave of defeats on Election Day that included Kamala Harris losing to Donald Trump. In the process of casting about for an explanation, one theory is that Trump w… [+6891 chars]	
Trump’s legal team tried to keep Stormy Daniels quiet (yes, again)	"By now, the basics of Donald Trumps Stormy Daniels scandal are probably familiar. There is, however, a new twist in the story, suggesting that the ordeal has an important new chapter.
As regular rea… [+4532 chars]"	
Trump insults Harris at Al Smith dinner while she barnstorms Wisconsin and mocks his ‘father of IVF’ claims	Former President Donald Trump on Thursday night insulted Vice President Kamala Harris family, repeatedly mispronounced her name and complained about how badly he was treated during his presidency, dr… [+4488 chars]	
Harris says ‘of course’ her team is prepared if Trump declares victory before votes are counted	In an interview with NBC News Hallie Jackson on Tuesday, Vice President Kamala Harris said she's preparing for the possibility that former President Donald Trump declares victory before the votes are… [+2335 chars]	
Trump again questions Harris' racial, ethnic identity in podcast interview	"Former President Donald Trump once again falsely questioned Vice President Kamala Harris' racial and ethnic identity during an interview with the ""PBD Podcast"" that aired on Thursday.
Trump -- who s… [+3195 chars]"	
McDonald's is the latest election battleground for Trump and Harris	"Donald Trump visited a McDonald's restaurant on Sunday.Doug Mills/Pool via REUTERS
Donald Trump visited a McDonald's in Pennsylvania on Sunday.It was the latest in a long tradition … [+3862 chars]"	
Elon Musk boosts Trump at rally underscored by racist rhetoric as Beyoncé rallies behind Harris	Elon Musk voiced his support for Donald Trump at a New York City campaign rally Sunday, but the event was underscored by crude and racist commentary from other speakers. Meanwhile, celebrities like B… [+132 chars]	
Elon Musk raises payment offer to $100 for voters who sign petition backing gun and speech rights	Billionaire Elon Musk has upped his financial offer for registered swing state voters to sign a conservative-leaning petition. On Thursday, Musk wrote on X that his pro-Trump super PAC would give $10… [+2692 chars]	
Kamala Harris scheduled to deliver 2024 campaign 'closing argument' at National Mall	"Vice President Kamala Harris will deliver a ""closing argument"" for why she believes she should be voters' choice in the 2024 election on the National Mall next Tuesday, according to a senior campaign… [+1883 chars]"	
Stocks soared on news of Trump's election. Bonds sank. Here's why.	"As Donald Trump emerged victorious in the presidential election Wednesday, stock prices soared.
As the stock market rose, the bond market fell.
Stocks roared to record highs Wednesday in the wake o… [+4293 chars]"	
Trump picks Kristi Noem to be Homeland Security secretary	"President-elect Donald Trump announced on Tuesday he has chosen South Dakota Gov. Kristi Noem to be his secretary for the Department of Homeland Security.
""Kristi has been very strong on Border Secu… [+4346 chars]"	
DOD ordered to turn over records from Trump's Arlington National Cemetery incident	A federal judge has ordered the Department of Defense to turn over records related to former President Donald Trump's controversial visit to Arlington National Cemetery meaning the public could soon … [+2413 chars]	
The list of Harris’ Republican backers adds some striking new names	Ahead of the 2022 midterm elections, then-Rep. Fred Upton saw the writing on the wall. The Michigan Republican a relative moderate by contemporary GOP standards had earned a lot of goodwill over the … [+3911 chars]	
Trump says he’d fire Jack Smith quickly if he wins another term in office | CNN Politics	Donald Trump said Thursday that he would use presidential powers to end Jack Smiths probe into multiple criminal cases hes brought against the former president, promising to fire the special counsel … [+3076 chars]	
What could abortion access look like under Trump?	Despite celebrating the passing of abortion-related ballot initiatives in seven states, abortion rights advocates warn that a second Donald Trump presidency puts nationwide access to abortion care in… [+3923 chars]	
Liberal filmmaker Michael Moore confidently declares Trump is 'toast'	"Liberal filmmaker Michael Moore is confident that former President Trump will not be making a political comeback on Tuesday, going so far as to say he's ""toast.""
The polls indicate that Trump and Vi… [+3389 chars]"	
Joe Rogan endorses Trump on eve of Election Day	The economy is the main issue for first time, Gen Z voters who spoke with NBC News at Trump's rally in Pittsburgh said this afternoon.Ryan Jones, 21, said he supports Trumps proposal for no taxes on … [+1659 chars]	
Inside the litigation election, where lawyers on both sides are duking it out in the courts like never before	The 2024 presidential election between Vice President Kamala Harris and former President Donald Trump is already beating litigation records.Robert Gauthier/Los Angeles Times via Getty Images; Rebecca… [+7993 chars]	
Kellyanne Conway: Donald Trump is rising from the ashes. Here's why Trump 2016 is Trump 2024	"Join Fox News for access to this content
Plus special access to select articles and other premium content with your account - free of charge.
By entering your email and pushing continue, you are ag… [+15136 chars]"	
Arnold Palmer's daughter calls Donald Trump 'disrespectful' after comments about her father	"Peg Palmer Wears, the daughter of late golf legend Arnold Palmer, responded to Donald Trumps recent comments about her father, which she considered ""disrespectful"" and ""inappropriate.""
Trump campaig… [+3334 chars]"	
Why Trump should avoid talking about intelligence leaks and Israel	Some classified U.S. intelligence documents related to Israel and a potential strike on Iran appeared online in recent days, and while officials in Israel have said the disclosure isnt likely to have… [+3709 chars]	
Election guardrails in 2024 and lost Chopin waltz discovered: Morning Rundown	Legal experts say an attempt to overturn the 2024 election results would be more difficult than in 2020. NBC News Andrea Mitchell writes about Antony Blinkens small victory in the Middle East. And a … [+9023 chars]	
‘SNL’ cast directly appeal to President-elect Donald Trump during cold open of post-election episode | CNN	Several of the cast members of Saturday Night Live took to the stage at Studio 8H in New York on Saturday in the first episode after the presidential election, where they jokingly appealed directly t… [+1881 chars]	
Kamala Harris' new lead in top Iowa poll could bode well for her in some key swing states	"A new Des Moines Register/Mediacom poll showed Vice President Kamala Harris with an advantage in GOP-leaning Iowa.ANGELA WEISS/AFP via Getty Images
A new Des Moines Register/Mediacom Iowa po… [+5338 chars]"	
Nick Bosa crashed a postgame interview to make Donald Trump statement	"Nick Bosa’s political leanings are nothing new.
In 2019, he deleted pro-Donald Trump social media posts. He was critical of Colin Kaepernick. What’s more, he was caught hitting the “like” button on … [+606 chars]"	
Ex-NASCAR star Danica Patrick explains Donald Trump will get her first-ever vote for president	"Former NASCAR star Danica Patrick confirmed on Jesse Watters Primetime that she has never voted in a presidential election in her life, but that will be changing in 2024. 
And she's revealed who she… [+3940 chars]"	
Who does China’s president want to win the U.S. election?	"U.S.-China ties will still be challenged during a Harris presidency but could be more stable than during the Trump and Biden years, Wu said.
Harris has never been to China but she has made multiple … [+3494 chars]"	
Election fact check: Trump, Harris on transgender issues	Millions of dollars from Republican groups and figures are being poured into anti-transgender ads criticizing policies that support the trans community, despite these issues being among the least imp… [+6958 chars]	
ALEX BERENSON: Why I'm voting for Donald J. Trump	"I wasnt planning to write this.
Two years ago, I said I would vote for a Democrat over Donald Trump
 in 2024. I wrote that during a Republican primary I hoped Florida Gov. Ron DeSantis would win; D… [+3523 chars]"	
'Tragic and shocking': Explosive House report details 'preventable' July 13 Trump rally shooting	"The deadly shooting at former President Trumps rally in Pennsylvania on July 13 was a ""preventable"" incident stemming from a lack of proper planning and communication between law enforcement agencies… [+5821 chars]"	
Former Trump aides are asking for the Supreme Court’s help as their ex-boss eyes the White House	"Yahoo is using AI to generate takeaways from this article. This means the info may not always match what's in the article. Reporting mistakes helps us improve the experience.Generate Key Takeaways
A… [+6745 chars]"	
Judge orders US Army to release records on Trump’s controversial Arlington Cemetery visit | CNN Politics	"The US Army has been ordered by a federal judge to release records related to former President Donald Trumps controversial August visit to Arlington National Cemetery by Friday at the latest.
The US… [+4180 chars]"	
New evidence makes Trump’s crusade against CBS far more difficult	In recent weeks, Donald Trump has been more animated and more fixated on one issue above all others. Its not immigration or the economy. It has nothing to do with transgender rights or trade tariffs.… [+3314 chars]	
Trump has made gains with Latino men — why they're voting red and how Harris is addressing it	"Chris Gonzalez, 33, just voted in his first presidential election. The Tucson, Arizona, resident cast his ballot for former President Donald Trump.
I just want the economy to be better, Gonzalez, cu… [+5620 chars]"	
What Trump's victory means for the Supreme Court	"President-elect Donald Trump has the potential to further reshape the Supreme Court in his second term.Al Drago/Getty Images
With Trump's victory and upcoming GOP control of the Senate, the … [+4842 chars]"	
‘Central Park Five’ members sue Trump for defamation after his debate comments on 1989 case | CNN Politics	"Members of the Central Park Five sued former President Donald Trump on Monday over false and defamatory statements they allege he made about their 1989 case during a presidential debate last month.
… [+1346 chars]"	
Fox News edited Trump’s rambling answers and false claims in barbershop interview, full video shows | CNN Business	"The Fox News Channels recent segment about Donald Trumps surprise visit to a barbershop in the Bronx resembled a campaign ad for the former presidents reelection.
Trump was seen taking questions and… [+3799 chars]"	
No recession risk regardless of who wins the White House, says Blackstone's Steve Schwarzman	"Steve Schwarzman is CEO of Blackstone, which manages assets of about $1 trillion.Reuters
Steve Schwarzman doesn't expect a recession whether Donald Trump or Kamala Harris win the election.</… [+3127 chars]"	
Trump and allies spread false noncitizen voting claims and World Series preview: Morning Rundown	Donald Trump and his allies are spreading a new big lie ahead of Election Day. A World Series matchup for the ages is set to begin. And a new report warns that online gambling poses a public health t… [+10476 chars]	
SEAN HANNITY: The American people no longer care what legacy media has to say	"Fox News host Sean Hannity reacts to the medias meltdown over President-elect Trumps win on ""Hannity
."" 
SEAN HANNITY: Tonight, it is official. The Democrats are definitely in disarray. Donald Trum… [+940 chars]"	
Nick Bosa is a coward who is afraid to back up wearing a MAGA hat with words	This is For The Wins daily newsletter, The Morning Win. Did a friend recommend or forward this to you? If so, subscribe here. Have feedback? Leave your questions, comments and concerns through this b… [+6829 chars]	
Far-right congressman suggests N.C. legislature should consider handing electors to Trump on Election Day	WASHINGTON The newly elected chairman of the far-right House Freedom Caucus, Rep. Andy Harris, suggested that North Carolinas Republican-controlled state legislature should consider awarding the stat… [+4291 chars]	
UFC stars tout Trump in appeal to Arab American voters in Michigan	Former President Donald Trump received the backing of a handful of UFC strong men last week as they spoke to Arab American voters in Michigan, which will likely be a key state on that path for a poss… [+2339 chars]	
Trump and Biden both call for smooth transition in historic Oval Office meeting	"President Joe Biden and President-elect Donald Trump are meeting in the Oval Office, resuming a tradition that Trump himself flouted in 2020.
The two men, seated by a roaring fire, shook hands. Bide… [+4424 chars]"	
Donald Trump Jr praises Patrick Mahomes' mom for support: 'Let's go America'	"Join Fox News for access to this content
Plus special access to select articles and other premium content with your account - free of charge.
By entering your email and pushing continue, you are ag… [+2861 chars]"	
Hillary Clinton says Trump is ‘more unhinged, more unstable’ than in 2016 | CNN Politics	Former Secretary of State Hillary Clinton said Thursday that former President Donald Trump is now more unhinged, more unstable and more dangerous than when she faced him in the 2016 presidential elec… [+2836 chars]	
What Donald Trump said he's getting Kamala Harris for her birthday	Former President Trump, who spent part of his afternoon serving food from a drive-thru window at a McDonalds in Pennsylvania, wished Vice President Kamala Harris a Happy Birthday, joking that he migh… [+2834 chars]	
More voters saw Trump as the candidate of change: Exit poll analysis	"Claiming superior leadership and casting himself as the true agent of change were keys to Donald Trump's victory in the presidential election, per ABC News exit poll results.
He also prevailed by a … [+2216 chars]"	
LAURA INGRAHAM: Donald Trump's 'stunning victory' was a 'total political vindication'	"Fox News host Laura Ingraham calls elites who counted out President-elect Trump since his first time running for office ""venal"" and ""selfish"" after his ""stunning victory"" on ""The Ingraham Angle
."" … [+1358 chars]"	
SNL cold open about the election includes Dana Carvey as Elon Musk	"How would Saturday Night Live deal with the recent presidential election results when they spend many a show mocking Donald Trump.
The answer is in the cold open from Saturday’s show hosted by Bill … [+396 chars]"	
What Americans heard about Trump heading into the campaign’s final week: fascism and french fries | CNN Politics	In the closing weeks of the 2024 campaign, much of the most discussed news around former President Donald Trump revolved around fascism and french fries, according to The Breakthrough, a CNN polling … [+3247 chars]	
US will stay in global climate fight despite Trump, says Podesta	The top US representative to COP29 defended his countrys progress in cutting planet-warming carbon emissions on Monday, insisting that much of it will endure despite President-elect Donald Trumps vow… [+4012 chars]	
